8 0

256 208

13 15

1 1 1 1 1 1 1 1 1 1 1 1 1 1 1
1 0 0 2 0 0 0 0 3 3 3 0 0 0 1
1 0 1 0 1 0 1 0 1 0 1 0 1 0 1
1 3 0 2 1 3 0 0 0 0 3 0 2 0 1
1 2 1 0 1 2 1 0 1 0 1 0 1 3 1
1 0 0 2 0 0 3 0 3 0 0 0 0 2 1
1 3 1 1 1 0 1 2 1 2 1 1 1 0 1
1 0 0 0 0 0 2 3 0 3 0 3 0 2 1
1 0 1 0 1 3 1 0 1 0 1 0 1 0 1
1 2 0 3 2 0 0 3 0 0 1 2 0 3 1
1 0 1 2 1 0 1 0 1 0 1 0 1 0 1
1 0 2 0 3 0 0 2 0 0 0 2 0 0 1
1 1 1 1 1 1 1 1 1 1 1 1 1 1 1

0

1 2

Resources/level2map.png
Resources/level1tiles.png

1 32 16 16
1 0
1

18 32 16 16
7 17
1 1 1 1 1 1 1

1 15 16 16
4 17
1 1 1 1

69 15 16 16
6 17
1 1 1 1 1 1
