8 0

256 208

13 15

1 1 1 1 1 1 1 1 1 1 1 1 1 1 1
1 0 0 0 0 0 0 0 3 3 3 0 0 0 1
1 0 1 0 1 0 1 0 1 0 1 0 1 0 1
1 0 0 2 0 3 0 0 0 0 3 0 2 0 1
1 2 1 0 1 2 1 2 1 0 1 0 1 0 1
1 0 0 2 0 0 3 0 3 0 0 0 0 2 1
1 3 1 3 1 0 1 2 1 2 1 0 1 0 1
1 0 0 0 0 0 2 0 0 3 0 3 0 2 1
1 0 1 0 1 3 1 0 1 0 1 0 1 0 1
1 2 0 3 2 0 0 3 0 0 0 2 0 3 1
1 0 1 2 1 0 1 0 1 0 1 0 1 0 1
1 0 0 0 3 0 0 0 0 0 0 2 0 0 1
1 1 1 1 1 1 1 1 1 1 1 1 1 1 1

0

2 2

Resources/level4map.png
Resources/level4tiles.png

1 15 16 16
1 0
1

18 15 16 16
6 17
1 1 1 1 1 1 

1 32 16 16
12 17
1 1 1 1 1 1 1 1 1 1 1 1

1 49 16 16
7 17
1 1 1 1 1 1 1